1111111111111
1001000000MC1
10000111110C1
1PM011E000011
1111111111111